2 13 31
###############################
#p * *    2   *  ** * *      x#
# # # # #*# # #*# # # # # #*# #
#    * * *b* **      *    **  #
# #*# # # # #3# # #1# # # # #*#
#          *     **      *  **#
# # # # # # # # #*#*#*#*# # # #
#   *   2    *   * *** *      #
# # # # #*# # # # # # #*# #*# #
#   ****         *1           #
# # # # # # # # # #*# # # # #*#
#  ** *   *   3      s        #
###############################