3 13 31
###############################
#p   **  *    *   2          f#
# # # #*# # # # # # # # # # # #
#*     ** * *  *   * ** 3 *   #
# # # # # #*# # # # # # #*# # #
#*   *b*    *** *   **      4 #
# # # # # # # # # # # # # #*# #
#    *     *   1    *    **  3#
# #*# # #*#*#*#*# # #1# # #*# #
#      4 *     *    *   *     #
#*# # # # # # # # # # #*# # x*#
# *    * **    ** ***     5   #
###############################