5 13 31
###############################
#p * *3       *  ** * *  5   *#
# # # # #*# # #*# # # # # #*# #
#    * * *** **  5   *    **  #
# #*# # # # #4# # #1# # # # #*#
#    3     *     **      *  *x#
# # #*# # # # # #*#*#*#*# # # #
#   *        *   * * * *   4  #
#1# # # #*# # # # # # #*# #*# #
#   ****         *2           #
# # # # # # # # # #*# # # # #*#
#  ** *5  *    2         3    #
###############################