4 13 31
###############################
#p ********b******s****f*****b#
# ****************************#
#*****************************#
#*******f*******s****f*****b**#
#*****************************#
#*****s*******s****f*****b****#
#*****************************#
#*s*******s****f*****b********#
#*****************************#
#*************s****f*****b****#
#*****b**********************x#
###############################